PS1="          ╔══╗╔═══╗ ╔╗  ╔═══╗╔═══╗
          ╚╣╠╝╚╗╔╗║╔╝║  ║╔══╝║╔═╗║
           ║║  ║║║║╚╗║  ║╚══╗║╚══╗
           ║║  ║║║║ ║║  ║╔══╝╚══╗║
          ╔╣╠╗╔╝╚╝║╔╝╚╗╔╝╚╗  ║╚═╝║
          ╚══╝╚═══╝╚══╝╚══╝  ╚═══╝
None@ID1FS:/home$ "
