PS1="██╗██████╗  ██╗███████╗███████╗
██║██╔══██╗███║██╔════╝██╔════╝
██║██║  ██║╚██║█████╗  ███████╗
██║██║  ██║ ██║██╔══╝  ╚════██║
██║██████╔╝ ██║██║     ███████║
╚═╝╚═════╝  ╚═╝╚═╝     ╚══════╝
ID1FS@ID1OS:/$ "
